00000000000000000000
00000000000000000000
00000000000000000000
00000000000000000000
00000000000000000000
11110000000000000000
00000000000000000000
00001110000000111100
00000000000000000000
00000000000000000000