00000000000000000000
00000000000000000000
00000000000000000000
00000000000000000000
00000011111100000000
00001111111111100000
00000000000000000000
00001110000000111100
00000000000000000000
00000000000000000000